






11111
10001
10001
10001
10001111111111111111111111111111
100000000000000000000000000000001
10001111111111111111111111111111
10001
10001
1111111

111111111
100000000111111
100000000100001
10000N000D000001
100000000100001
11111111111111

