






 1111
 10001
111

111111111
100000000111111
100000000100001
10000N000D000001
100000000100001
11111111111111

