NO ./assets/sprites/crefadet.xpm
SO ./assets/sprites/zekrom.xpm
EA ./assets/sprites/artikodin.xpm
F ./assets/sprites/floor.xpm
WE    ./assets/sprites/mewtwo.xpm
C 200,200,200




11111111111111111111
10000000000000000001
10001111110111111111
10001   101
11011    11
11111

111111111111111111111
10a01000BB00000010001
111D10111111101110101
101010100010100000101
101010101010111111101
1010100B10001B0010001
101011101111101010101
10100B101000001000101
101110101011111111101
101000101010001000B01
101011111010111011111
100010000010100010001
101110111110101110111
101000100000100010001
101011101110111011101
100010000010001000001
111110111011111111101
1000BB101000000000101
101111101111111011101
10000000000B0000000e1
111111111111111111111


11111111111111
10000000000001
100000000B00M1
100000N00B0001
1e00000000H0D1
1000000a00M001
10BB000000b001
11111111111111

111111111
10B0000B0111111
1000000001000B11111111111111111
1000b0000D000000000D0000000000e1
10B00000B1000B11111111111111111
11111111111111              

1111111
10000001
11111111


11111
11001
10001
10001
10001111111111111111111111111111
100000000000000000000000000000001
10001111111111111111111111111111
10001
10001
1111111
10001
11111

111111111
100000000111111
100000000100001
100000000D000001
100000000100001
11111111111111

