11111111111111111111
100000000000a00000N1
10001111110111111111
10a001   101
11011    11
11111

111111111111111111111
10D010000000000010001
111010111111101110101
101010100010100000101
101010101010111111101
101010001000100010001
101011101111101010101
101000101000001000101
101110101011111111101
101000101010001000001
101011111010111011111
100010000010100010001
101110111110101110111
101000100000100010001
101011101110111011101
100010000010001000001
111110111011111111101
100000101000000000101
101111101111111011101
1000000000000000000e1
111111111111111111111

11111111111111111
10000000000000001
10000000000000001
10000000000000001
10000000000000001
10000000000000001
10000000000000001
10000000000000001
10000000000000001
10000000000000001
10000000000000001
10000000000000001
10000000000000001
11111111111111111



111111111
100000000111111
1000000001000011111111111111111
10000N000D0000000000000000000001
1000000001000011111111111111111
11111111111111              

1111111
100000010
11111111


11111
11001
10001
10001
10001111111111111111111111111111
100000000000000000000000000000001
10001111111111111111111111111111
10001
10001
1111111
10001
11111

111111111
100000000111111
100000000100001
10000N000D000001
100000000100001
11111111111111

