NO ./assets/sprites/crefadet.xpm
SO ./assets/sprites/zekrom.xpm
EA ./assets/sprites/artikodin.xpm
F ./assets/sprites/floor.xpm
WE    ./assets/sprites/mewtwo.xpm
C 0,0,0




                   11111111111111111
                   1B000000000000B01
                   1000E00e000000001
                   10000000000000001
                   1000000B000000001
                   1000B00000B000001
                   100000000000M0001
                   11111111D11111111
                        1000001
                        1000001
                        1000001
                        100B001
                        1000001
                        100a001
                         11111


                  11111111111111111111111       11111
                  10000000000000000000001       100b01
                  1000000000a000000000001       1000001
                  10000000000000000000001       10000001
                  10000B000000000000000011111111110000001
                  1000000000000000000000D00000000000000001
                  100000000000000000000011111111111111111
                  1000B000H00000000B00001
                  10000000000000000000001
                  111111111D1111111111111
                          101
                          101
                          1B1
                          101
                          101
            111111111111111D11111111111111
            100000000000000000000000000001
            10000d000000000000000f00000001
            100000000000000000000000000001
            100000000000000000000000000001
            1000000000g0000000000000g00001
            100000000000000000000000000001
            100000000000000000000000000001
             1000f0000000000000000d000001
              10000000000000000000000001
               100000000000000000000001
                1111110000000000111111
                     100000000001
                     110000000011
                       11000011
                         10c01
                         10M01
                         11111



11111111111111111111111
1M00B000B000B000B000B01
1M000000000000000000001
100H00B0M00B0M00B0000B1
10000000000000000000001
1B0000000000000000000B1
10H0000000b000000000001
1B0000000000000000000B1
100000000000000000000M1
1B00000B0000B0000B000M1
1000B00B00B00B00B00B001
11111111111111111111111


      1111111
      1000001
      100c001
      1000001
      1000001
      1000001
      1000001
      1B000B1
      111D111
      1000001
      1000001
      100BB01
      10B00M1
      1110111
111111111D11111111
10B0000000000B0001
1000H00000000000B1
1B000000000000B001
10B0000000000B0001
100B00000000B00001
1000B000000B0e0001
10000B000B00000001
111111111111111111