NO ./assets/sprites/crefadet.xpm
SO ./assets/sprites/zekrom.xpm
EA ./assets/sprites/artikodin.xpm
F ./assets/sprites/floor.xpm
WE    ./assets/sprites/mewtwo.xpm
C 0,0,0

111111111111111111111111111111  
100000000000000000000000000001  
10000000000000000000000000a001  
1000H0000000000000000000000001  
100000000000000000000000000001  
100000000000000000000000000001  
1000000000000000M0000000000001  
100000000000000000000000000001  
101111111111111111111111111101  
100000000000000000000000000001  
100000000000000000000000000001  
100000000000000000000000000001  
100000000000000000000000000001  
100000000000000000000000000S01  
111111111111111111111111111111  

111111111111111111111111111111  
100000000000000000000000000001  
101111111111111111111111111101  
100000000000000000000000000001  
101111111111111111111111111101  
100000000000000000000000000001  
1000H0000000000000000000M00001  
101111111111111111111111111101  
100000000000000000000000000001  
100011111111111111111111111001  
10a000000000000000000000000001  
101111111111111111111111111101  
100000000000000000000000000001  
10000000000000000000000e000001  
111111111111111111111111111111  
