NO ./assets/sprites/crefadet.xpm
SO ./assets/sprites/zekrom.xpm
EA ./assets/sprites/artikodin.xpm
F ./assets/sprites/floor.xpm
WE    ./assets/sprites/mewtwo.xpm
C 0,0,0


                          11111
                         110e0011
                        1100000011
                        1000000001
                        1000000001
                        1000000001
                        1000000001
                        1000000001
                        1000000001
                        1000000001
                        1000000001
                        1000000001
                        1000000001
                 11111111000000001111111111111111
             11110000001100000000110000001110000111
          111111000000001000000001000000001000000111
        111100010000000010000000010000000010000000111
      111100000100000000100000000100000000100000000111
     1110000000100000000100000000100000000100000000111
    111000000001000000001000000001000000001000000000111
   111000000000000000000000000000000000000000000000000111
  1110000000000000000000000000000000000000000000000000011
  1100000000000000000000000000000000000000000000000000001
  11000000000000000000000000000000000000000000000000000001
  11000000000000000000000000000000000000000000000000000001
  11000000000000000000000000000000000000000000000000000001
  11000000000000000000000000000000000000000000000000000001
  11000000000000000000000000000000000000000000000000000001
  11000000000000000000000000000000000000000000000000000001
  11000000000000000000000000000000000000000000000000000001
  11000000000000000000000000000000000000000000000000000001
  11000000000000000000000000000000000000000000000000000001
   1100000000000000000000000000000000000e00000000000000011
    110000000000000000000000000000000000000000000000000111
     1100000000000B000000000000000000000000000000000000111
     1110000000000000000000000000000000000000000000000111
      1111000000000000000000000000000000000000000000111
        1111100000000000000000000000D000000000000111
            1111110000000000000000aaNe00000001111
                111111111111111111111111111111