NO ./assets/sprites/crefadet.xpm
SO ./assets/sprites/zekrom.xpm
EA ./assets/sprites/artikodin.xpm
F ./assets/sprites/floor.xpm
WE    ./assets/sprites/mewtwo.xpm
C 0,0,0

1111111111111111   
1a00000000000111   
1011110111100011   
1000010100000111   
1111010111111111   
1e00001000000001   
1111111111101011   
    111000100001   
    101111101011   
    100000000011   
    111111111111   

111111111111111111111    
1b0000000110000000001    
111011110111011111101    
100010000000000100001    
101111011111110111101    
100000010001000100001    
111111111011011111111    
1a0000001000000000001    
111111101111011111101    
     1000010001000001    
     1111011111111011    
     10000000c00000g1    
     1111111111111111   

1111111
1000001
100S001
1000001
1000001
1c000g1
100B001
1000001
1000001
1000001
1000001
1000001
1000001
1000001
1000001
1000001
1000001
1000001
1000001
1000001
1000001
1000001
1000001
10000b1
1000001
111111