NO ./assets/sprites/crefadet.xpm
SO ./assets/sprites/zekrom.xpm
C 0,0,0
EA ./assets/sprites/artikodin.xpm
F ./assets/sprites/floor.xpm
WE    ./assets/sprites/mewtwo.xpm






111111111111111111111111111
1E000000000000B000000000001
100000000000000000000000B01
10000H000000000000000000001
1000000000000B000000000001
100000000000B0000000000001
1B0000000000000000000000B1
1000000000000000g000000001
1B0000000000000000000000B1
100000000000000000000000M1
1000B0000B000B0000B0000B01
10000000000000000000000001
11111111111111111111111111

       1111111111111111
       1000000g00000001
       1B00000000000001
       10000B0000000B01
       1000000000000001
       100B000000000B01
       1000000000000001
       1B000000000000B1
       111111111D111111
               101
               1B1
               101
               1001
               1001
               1H01
1111111111111111D1111111111
1B00000000000000000B000M1
10000000000000000000000001
100000000000000000000000B1
1B00000B0B00B00B00B000001
1000B0000000000000000M0001
1B0000000000H0000000000001
1000B0000000B0000000a00B01
111111111111111111111111111

       111111
       100a01
       100001
       1B0001
       100001
       100001
       10000B1
       100001
       1B000B1
       111D111
       1000001
       1000B01
       1M00001
       1100111
111111111D11111111
10B0000000000B0001
1000000000000000B1
1B0000000000000001
1000000000000B0001
100000B000000B00001
100B000000000000001
100000B000000B00001
10000B00000000e0001
1111111111111111111
