NO ./assets/sprites/crefadet.xpm
SO ./assets/sprites/zekrom.xpm
EA ./assets/sprites/artikodin.xpm
F ./assets/sprites/floor.xpm
WE    ./assets/sprites/mewtwo.xpm
C 0,0,0



                                         111
                                         1N1
                                         101
                                         101
   11111111111111111111111111111111111111101111111111111111111111
   100000000000000000000000000000000000000000000000000000000000001
   10111111111111111111111110111111111111111111111111111111111111
   101                     101
   101                     10111111111
111101111                  10000000001
100000001                  10000000001
10H000001                  10000000001
100000001                  10000H00001
1000b0001                  100000M0001
111111111                  11111111111

11111111111111111111111111111111111111111
100000000000000001b1000000000000000000001
10000000000000000101000000000000000000001
10000000000000000101000000000000000000001
10000000000000000000000000000000000000001
100000000000000M0000000000000000000000001
10000000000000000000000000000000000000001
10000000000000000000000000000000000000001
10000000000000000000000000000000000000001
10000000000001111111111100000000000000001
10000000000000000000000000000000000000001
10000000000000000000000000000000000000001
10000000000000000000000000000000000000001
10000000000000000000000000000000000000001
10000000000000000000000000000000000000001
10000000000000000000000000000000000000001
10000000000000000000000000000000000000001
10000000000000000000000000000000000000001
10000000000000000000000000000000000000001
10000000000000000000000000000000000000001
10000000000000000000000000000000000000001
10000000000000000000000000000000000000001
10000000000000000000000000000000000000001
10000000000000000000000000000000000000001
10000000000000000000000000000000000000001
10000000000000000000000000000000000000001
1000000000000000000M000000000000000000001
1000000000000000M00e00M000000000000000001
1000000000000000000M000000000000000000001
10000000000000000000000000000000000000001
11111111111111111111111111111111111111111