NO ./assets/sprites/crefadet.xpm
SO ./assets/sprites/zekrom.xpm
EA ./assets/sprites/artikodin.xpm
F ./assets/sprites/floor.xpm
WE    ./assets/sprites/mewtwo.xpm
C 0,0,0

111111
10010111
101001
110DE11
1111B1
    1